1 9 817 1486 1080 1898 767 4674 4670 4671 4675 
1 3 4675 4676 2856 
1 8 2856 1841 1661 2905 912 2930 1574 2926 
1 4 817 2867 1436 2309 
1 9 1237 1520 1467 2849 1779 2841 2851 4679 817 
1 5 2905 153 4666 1896 4674 
1 8 2926 2190 2928 2932 922 1961 1476 2309 
1 9 1237 2901 1345 2177 640 2924 2931 1142 1476 
1 15 817 4679 2831 963 2797 1598 732 1325 2734 2726 2718 2703 2697 548 1038 
1 2 4619 4626 
1 6 2234 4697 4710 547 1219 4701 
